#2:en:Testlevel:de:Teststufe#
WWWWWWWWWWWWWWWWWWWWWWWWWWWWWWWW
W______________________________W
W______________________________W
W______________________________W
W______________________________W
W______________________________W
W______________________________W
E______________________________W
W___MMM________________________W
WF_____________________________W
Wa_____________________________W
WHC_b__________________________W
W_S____________________________W
WCC____________________________W
W______________________________W
W______________________________W
W______________________________W
W______________________________W
W______________________________W
W______________________________W
W______________________________W
W______________________________W
W______________________________W
W______________________________W
W______________________________W
W______________________________W
W______________________________W
W______________________________W
W______________________________W
W______________________________W
W______________________________W
WWWWWWWWWWWWWWWWWWWWWWWWWWWWWWWW
