#1:en:Testlevel1:de:Teststufe1#
WWWWWWWWWWWWWWWWWWWWWWWWWWWWWWWW
W______________________________W
W______________________________W
W______________________________W
W______________________________W
W______________________________W
W______________________________W
E______________________________W
W______________________________W
W______________________________W
W______________________________W
W______________________________W
W______________________________W
W______________________________W
W______________________________W
W______________________________W
W______________________________W
W______________________________W
W______________________________W
W______________________________W
W______________________________W
W______________________________W
W______________________________W
W______________________________W
W______________________________W
WF_____________________________W
WMMMab_________________________W
WSSSSSSSSSSSSSSSSSSSSSSSC______W
W___FF_________________________W
W___MF_________________________W
W___BH_________________________W
WWWWWWWWWWWWWWWWWWWWWWWWWWWWWWWW
