#1:en:Testlevel:de:Teststufe#
WWWWWWWWWWWWWWWWWWWWWWWWWWWWWWWW
W______________________________W
W______________________________W
W______________________________W
W______________________________W
W______________________________W
W______________________________W
E______________________________W
W______________________________W
W______________________________W
W______________________________W
W______________________________W
W______________________________W
W______________________________W
W______________________________W
W______________________________W
W______________________________W
W______________________________W
W______________________________W
W______________________________W
W______________________________W
W______________________________W
W______________________________W
W______________________________W
W______________________________W
W______________________________W
W______________________________W
W_____F________________________W
W_____Mab______________________W
W____FBF_______________________W
W____F_FMS_____________________W
WWWWWWWWWWWWWWWWWWWWWWWWWWWWWWWW
