#1:en:Testlevel:de:Teststufe#
WWWWWWWWWWWWWWWWWWWWWWWWWWWWWWWW
W______________________________W
W______________________________W
W______________________________W
W______________________________W
W______________________________W
W______________________________W
E______________________________W
W______________________________W
W______________________________W
W______________________________W
W______________________________W
W______________________________W
W______________________________W
W______________________________W
W______________________________W
W______________________________W
W______________________________W
W______________________________W
W______________________________W
W______________________________W
W______________________________W
W______________________________W
W______________________________W
W______________________________W
W______________________________W
W____b_________________________W
W______________________________W
W___FF_________________________W
W__aMF_________________________W
W___BH_________________________W
WWWWWWWWWWWWWWWWWWWWWWWWWWWWWWWW
