#1:en:Testlevel1:de:Teststufe1#
WWWWWWWWWWWWWWWWWWWWWWWWWWWWWWWW
W______________________________W
W______________________________W
W______________________________W
W______________________________W
W______________________________W
W______________________________W
E______________________________W
W___MMM________________________W
W______________________________W
WF____________F________________W
WM__b_________aF_______________W
WS__________BMBMC______________W
WMC_________M_MM_______________W
W_B____________M_______________W
W_M____________________________W
W______________________________W
W______________________________W
W______________________________W
W______________________________W
W______________________________W
W______________________________W
W______________________________W
W______________________________W
W______________________________W
W______________________________W
W______________________________W
W______________________________W
W______________________________W
W______________________________W
W______________________________W
WWWWWWWWWWWWWWWWWWWWWWWWWWWWWWWW
