#1:en:Testlevel:de:Teststufe#
WWWWWWWWWWWWWWWWWWWWWWWWWWWWWWWW
W______________________________W
W______________________________W
W______________________________W
W______________________________W
W______________________________W
W______________________________W
E______________________________W
W______________________________W
W______________________________W
W______________________________W
W______________________________W
W______________________________W
W______________________________W
W______________________________W
W______________________________W
W______________________________W
W______________________________W
W______________________________W
W______________________________W
W______________________________W
W______________________________W
W______________________________W
W______________________________W
W______________________________W
W______________________________W
W___Fb_________________________W
W___a__________________________W
W______________________________W
W__FBF_________________________W
W__F_F_________________________W
WWWWWWWWWWWWWWWWWWWWWWWWWWWWWWWW
