#1:en:In The Beginning...:de:Am Anfang...#
WWWWWWWWWWWWWWWWWWWWWWWWWWWWWWWW
W__________VV_______VVV__XX_X__W
W_WWWWWWWWWWVWWWWWWWWWWWWWWWWWXW
W_WMH___m_bW________VVVVV____W_W
WMW______WWWWWWWWWWWWWWWWWWW_WXW
W_WWW____M_________________W_W_W
W___WWWWWWWWWWWWWWWWWWWpWW_W_W_W
WWW_WMWV_________________W_W_WEW
WVV_W_WMWWWWVWWWVVHWWWWW_W_W_W_W
WMH_W_WWH_____MH_M_HM__W_W_V_WaW
WMHWW_WMH_WWWWWWWWWWWW_WMW_W_W_W
WMHWWHW_H_WMWM_______W_WWW_W_W_W
WMHWWHW_H_W_WWWVVVVW_W_WMW_W_W_W
WHH_WoW_H__________W_W_W_W_W_W_W
WWW_WHW_W_W_WMWW_W_W_W_W_W_W_W_W
WMW_W_W_W_W_WWWMMH_H___H___H_H_W
W_W_W_W_W_WMWMW_MW_W_W_W_W_W_W_W
W_W_W_W_W_WWW_WWWW_W_W_W_W_W_W_W
W_W_W_W___W________W_W_W_W_W_W_W
WMW_W_W_WWW_WWWWWVWW_W_W_WMW_W_W
W_W_W_W_WMH_W_______MW_W_WWW_W_W
W_W_W_W__MH_WVHVWWWWWW_W_WMW_W_W
WMW_V_W_WMH_VVHHWM_______W_W_W_W
W_WWW_W_WWWWWHVVWWWWWWWW_W_W_W_W
W_WMWHW___VMWVVHMWMV_____W_WMW_W
W_WMWHWWWWHWWWWWWWWWWWWWHW_WWW_W
W_W_WMWMMVH________________WM__W
W_V_WWWWWWW_WWWWWWWWWWWWVWWW___W
W_WV____________________MWM____W
W_WWVWWWWWWWVVVVVVVVVWWWWW_M_nVW
W____________________________HMW
WWWWWWWWWWWWWWWWWWWWWWWWWWWWWWWW

