#1:en:Testlevel:de:Teststufe#
WWWWWWWWWWWWWWWWWWWWWWWWWWWWWWWW
W______________________________W
W______________________________W
W______________________________W
W______________________________W
W________F_F___P__FF___________W
W________M_M___P_______________W
E______________________________W
W_______MBM____________________W
Wb__MC___M_P___________________W
Wa_____________________________W
WM_____________________________W
W_S_MC_________________________W
WM_____________________________W
W______________________________W
W______________________________W
W______________________________W
W______________________________W
W______________________________W
W______________________________W
W______________________________W
W______________________________W
W______________________________W
W______________________________W
W______________________________W
W______________________________W
W______________________________W
W______________________________W
W______________________________W
W______________________________W
W______________________________W
WWWWWWWWWWWWWWWWWWWWWWWWWWWWWWWW
